File name;Lines in the file;Matched lines;Error matched lines;Number of matched SNPs;Number of Alleles matched;Number of rules triggered
user1004_file498_yearofbirth_unknown_sex_unknown.23andme.txt;1766;0;0;0;0;0
user1001_file496_yearofbirth_unknown_sex_unknown.23andme.txt;701479;0;0;0;0;0
user1005_file541_yearofbirth_1981_sex_XY.23andme.txt;707269;120;1;119;3;0
user1002_file497_yearofbirth_unknown_sex_unknown.23andme.txt;960613;288;11;277;4;1
user1010_file502_yearofbirth_1984_sex_XY.23andme.txt;574514;225;7;218;5;5
user1017_file505_yearofbirth_unknown_sex_unknown.23andme.txt;3;0;0;0;0;0
user1006_file499_yearofbirth_unknown_sex_unknown.23andme.txt;701478;116;0;116;3;1
user1013_file503_yearofbirth_unknown_sex_unknown.23andme.txt;960613;284;9;275;5;4
user1020_file507_yearofbirth_unknown_sex_unknown.23andme.txt;960613;284;8;276;6;5
user1024_file510_yearofbirth_1971_sex_XX.23andme.txt;960613;288;11;277;6;5
user1022_file508_yearofbirth_unknown_sex_unknown.23andme.txt;960613;284;10;274;6;5
user1026_file511_yearofbirth_unknown_sex_unknown.23andme.txt;960613;288;12;276;4;4
user1028_file514_yearofbirth_unknown_sex_unknown.23andme.txt;960613;288;11;277;5;4
user1029_file515_yearofbirth_unknown_sex_unknown.23andme.txt;960613;288;14;274;5;4
user1033_file567_yearofbirth_1992_sex_XY.23andme.txt;960613;284;11;273;5;4
user1034_file517_yearofbirth_unknown_sex_unknown.23andme.txt;960613;284;13;271;4;4
user1036_file519_yearofbirth_unknown_sex_unknown.23andme.txt;991786;296;9;287;19;2
user1039_file521_yearofbirth_1958_sex_XY.23andme.txt;960613;284;11;273;5;4
user1038_file520_yearofbirth_unknown_sex_unknown.23andme.txt;960613;288;12;276;3;4
user1042_file524_yearofbirth_unknown_sex_unknown.23andme.txt;701479;0;0;0;0;0
user103_file50_yearofbirth_unknown_sex_unknown.23andme.txt;966983;298;20;278;5;5
user1040_file522_yearofbirth_unknown_sex_unknown.23andme.txt;960613;284;14;270;5;4
user1041_file523_yearofbirth_unknown_sex_unknown.23andme.txt;960613;288;13;275;4;4
user1045_file526_yearofbirth_1972_sex_XX.23andme.txt;960613;288;13;275;6;4
user1046_file527_yearofbirth_unknown_sex_unknown.23andme.txt;960613;284;11;273;4;4
user1047_file528_yearofbirth_1958_sex_XY.23andme.txt;960613;284;13;271;8;5
user1048_file529_yearofbirth_unknown_sex_unknown.23andme.txt;960613;284;13;271;14;4
user1051_file530_yearofbirth_1949_sex_unknown.23andme.txt;960613;288;12;276;6;5
user1059_file535_yearofbirth_unknown_sex_unknown.23andme.txt;701479;115;0;115;2;1
user1053_file531_yearofbirth_unknown_sex_unknown.23andme.txt;960613;284;11;273;6;5
user1058_file533_yearofbirth_unknown_sex_unknown.23andme.txt;960613;288;16;272;15;4
user1060_file536_yearofbirth_1971_sex_unknown.23andme.txt;960613;284;12;272;4;4
user1063_file540_yearofbirth_unknown_sex_unknown.23andme.txt;960613;284;14;270;6;5
user1064_file542_yearofbirth_unknown_sex_unknown.23andme.txt;960613;288;11;277;6;2
user1062_file538_yearofbirth_unknown_sex_unknown.23andme.txt;966983;298;19;279;5;4
user1066_file543_yearofbirth_unknown_sex_unknown.23andme.txt;960613;284;9;275;5;5
user1072_file548_yearofbirth_unknown_sex_unknown.23andme.txt;960613;284;12;272;7;5
user1075_file550_yearofbirth_unknown_sex_unknown.23andme.txt;960613;288;14;274;6;4
user1071_file552_yearofbirth_1968_sex_XY.23andme.txt;991786;296;10;286;16;4
user1077_file551_yearofbirth_unknown_sex_unknown.23andme.txt;960613;284;12;272;3;4
user1078_file553_yearofbirth_1974_sex_XX.23andme.txt;701479;0;0;0;0;0
user1081_file556_yearofbirth_unknown_sex_unknown.23andme.txt;2459;0;0;0;0;0
user1079_file554_yearofbirth_unknown_sex_unknown.23andme.txt;960613;288;10;278;6;5
user107_file51_yearofbirth_1965_sex_XX.23andme.txt;960520;290;10;280;5;4
user1085_file557_yearofbirth_unknown_sex_unknown.23andme.txt;960613;284;14;270;5;4
user1087_file558_yearofbirth_unknown_sex_unknown.23andme.txt;960613;288;11;277;5;5
user1089_file559_yearofbirth_unknown_sex_unknown.23andme.txt;960613;288;13;269;461;42
user1091_file560_yearofbirth_1990_sex_XY.23andme.txt;960613;284;12;272;5;4
user1094_file563_yearofbirth_unknown_sex_unknown.23andme.txt;960613;284;15;269;5;5
user1097_file564_yearofbirth_unknown_sex_unknown.23andme.txt;960613;284;7;277;4;4
user10_file3_yearofbirth_1982_sex_XY.23andme.txt;966983;298;19;279;5;5
user1103_file565_yearofbirth_unknown_sex_XX.23andme.txt;960613;288;11;277;5;4
user1106_file568_yearofbirth_unknown_sex_unknown.23andme.txt;960613;284;13;269;461;42
user1108_file571_yearofbirth_unknown_sex_unknown.23andme.txt;701479;0;0;0;0;0
user1108_file572_yearofbirth_unknown_sex_unknown.23andme.txt;701479;0;0;0;0;0
user1107_file570_yearofbirth_unknown_sex_XX.23andme.txt;960613;288;14;274;4;4
user117_file53_yearofbirth_1981_sex_XY.23andme.txt;574404;224;5;219;6;5
user1112_file573_yearofbirth_unknown_sex_unknown.23andme.txt;960613;284;10;274;5;5
user118_file52_yearofbirth_1970_sex_XY.23andme.txt;576517;227;5;222;15;4
user1114_file574_yearofbirth_unknown_sex_unknown.23andme.txt;960613;284;17;267;6;5
user11_file176_yearofbirth_unknown_sex_unknown.23andme.txt;960520;286;12;274;15;4
user123_file54_yearofbirth_unknown_sex_unknown.23andme.txt;1003773;312;18;294;4;4
user124_file55_yearofbirth_1947_sex_XX.23andme.txt;960520;290;10;280;5;4
user125_file56_yearofbirth_1976_sex_XY.23andme.txt;991624;297;11;286;7;5
user126_file57_yearofbirth_unknown_sex_unknown.23andme.txt;578337;229;6;223;5;5
user139_file59_yearofbirth_unknown_sex_unknown.23andme.txt;966983;298;21;277;6;2
user13_file4_yearofbirth_1979_sex_XY.23andme.txt;966983;298;20;278;4;4
user137_file58_yearofbirth_unknown_sex_unknown.23andme.txt;996065;307;18;289;3;4
user143_file75_yearofbirth_unknown_sex_unknown.23andme.txt;574405;224;8;216;4;4
user141_file60_yearofbirth_unknown_sex_unknown.23andme.txt;960520;286;14;272;6;5
user144_file61_yearofbirth_unknown_sex_unknown.23andme.txt;966983;298;19;279;4;4
user146_file62_yearofbirth_1971_sex_XY.23andme.txt;960545;286;14;272;3;4
user148_file63_yearofbirth_1971_sex_XY.23andme.txt;576516;227;6;221;16;5
user158_file66_yearofbirth_unknown_sex_unknown.23andme.txt;1677118;0;0;0;0;0
user14_file6_yearofbirth_unknown_sex_unknown.23andme.txt;576517;231;6;225;16;4
user154_file65_yearofbirth_unknown_sex_unknown.23andme.txt;966983;298;19;279;8;5
user161_file68_yearofbirth_unknown_sex_unknown.23andme.txt;574405;228;5;223;5;5
user159_file67_yearofbirth_1984_sex_XX.23andme.txt;960545;290;11;279;7;5
user160_file153_yearofbirth_unknown_sex_unknown.23andme.txt;960545;290;12;278;7;1
user165_file71_yearofbirth_unknown_sex_unknown.23andme.txt;960545;286;11;275;6;2
user169_file74_yearofbirth_unknown_sex_unknown.23andme.txt;574405;224;6;218;4;4
user168_file73_yearofbirth_1988_sex_XY.23andme.txt;960520;286;11;275;3;4
user175_file76_yearofbirth_1974_sex_XY.23andme.txt;960545;286;10;276;5;4
user177_file78_yearofbirth_unknown_sex_unknown.23andme.txt;960545;286;10;276;5;4
user17_file143_yearofbirth_unknown_sex_XX.23andme.txt;578320;233;11;222;16;1
user180_file322_yearofbirth_1980_sex_XY.23andme.txt;574405;224;5;219;15;5
user183_file80_yearofbirth_unknown_sex_unknown.23andme.txt;960520;286;12;274;3;1
user181_file79_yearofbirth_unknown_sex_unknown.23andme.txt;960545;286;11;275;4;4
user187_file267_yearofbirth_unknown_sex_unknown.23andme.txt;574514;225;5;220;6;5
user189_file174_yearofbirth_unknown_sex_unknown.23andme.txt;960545;290;11;279;4;4
user192_file82_yearofbirth_unknown_sex_XX.23andme.txt;966983;302;19;283;6;5
user199_file86_yearofbirth_unknown_sex_unknown.23andme.txt;966983;298;23;269;461;42
user19_file7_yearofbirth_unknown_sex_unknown.23andme.txt;996062;306;18;288;18;5
user1_file9_yearofbirth_1985_sex_XY.23andme.txt;966983;298;20;278;14;4
user200_file84_yearofbirth_unknown_sex_unknown.23andme.txt;960545;286;10;276;3;4
user202_file85_yearofbirth_unknown_sex_unknown.23andme.txt;960545;286;11;275;16;5
user204_file88_yearofbirth_1957_sex_XY.23andme.txt;960545;286;12;274;4;4
user207_file89_yearofbirth_unknown_sex_unknown.23andme.txt;960545;286;11;275;7;5
user20_file45_yearofbirth_unknown_sex_unknown.23andme.txt;574404;224;6;218;3;4
user215_file91_yearofbirth_unknown_sex_unknown.23andme.txt;576516;227;14;213;4;4
user212_file90_yearofbirth_unknown_sex_unknown.23andme.txt;960545;286;11;275;16;5
user216_file109_yearofbirth_1984_sex_XY.23andme.txt;960545;286;11;275;13;4
user217_file92_yearofbirth_unknown_sex_unknown.23andme.txt;960545;286;13;273;4;4
user229_file102_yearofbirth_unknown_sex_unknown.23andme.txt;574405;224;5;219;16;5
user22_file8_yearofbirth_1975_sex_XY.23andme.txt;966977;297;19;278;6;5
user231_file93_yearofbirth_unknown_sex_unknown.23andme.txt;966983;298;20;278;7;2
user240_file94_yearofbirth_1948_sex_XX.23andme.txt;966983;302;19;283;5;4
user241_file107_yearofbirth_1984_sex_XY.23andme.txt;991624;297;12;285;8;5
user251_file97_yearofbirth_unknown_sex_XX.23andme.txt;960545;290;10;280;4;4
user252_file99_yearofbirth_unknown_sex_unknown.23andme.txt;574405;224;5;219;5;5
user253_file98_yearofbirth_unknown_sex_unknown.23andme.txt;966977;297;19;278;4;4
user254_file100_yearofbirth_1900_sex_XY.23andme.txt;966977;297;20;277;6;5
user258_file101_yearofbirth_unknown_sex_unknown.23andme.txt;960545;286;12;274;6;5
user262_file103_yearofbirth_1975_sex_XY.23andme.txt;578320;229;6;223;4;4
user266_file104_yearofbirth_unknown_sex_unknown.23andme.txt;960545;286;12;274;4;4
user267_file105_yearofbirth_unknown_sex_unknown.23andme.txt;574405;228;6;222;15;1
user268_file106_yearofbirth_unknown_sex_unknown.23andme.txt;960545;290;12;278;5;5
user26_file10_yearofbirth_unknown_sex_unknown.23andme.txt;966983;298;19;279;5;1
user277_file111_yearofbirth_unknown_sex_unknown.23andme.txt;18;0;0;0;0;0
user276_file110_yearofbirth_1972_sex_XY.23andme.txt;960545;286;10;276;4;4
user278_file112_yearofbirth_unknown_sex_XX.23andme.txt;645363;60;0;60;0;0
user279_file113_yearofbirth_unknown_sex_unknown.23andme.txt;960545;290;10;280;5;5
user280_file114_yearofbirth_1989_sex_XX.23andme.txt;991624;301;11;290;4;4
user281_file116_yearofbirth_unknown_sex_unknown.23andme.txt;960545;290;10;280;6;5
user284_file117_yearofbirth_1961_sex_XY.23andme.txt;991600;297;12;285;16;4
user285_file118_yearofbirth_1976_sex_XY.23andme.txt;996065;307;17;290;5;1
user287_file120_yearofbirth_unknown_sex_unknown.23andme.txt;966983;298;19;279;4;4
user288_file121_yearofbirth_1987_sex_XX.23andme.txt;960545;290;13;277;5;4
user294_file125_yearofbirth_1963_sex_XY.23andme.txt;966983;298;20;278;3;4
user295_file126_yearofbirth_unknown_sex_unknown.23andme.txt;966983;298;19;279;6;5
user296_file127_yearofbirth_unknown_sex_unknown.23andme.txt;960545;286;11;275;6;7
user301_file131_yearofbirth_unknown_sex_unknown.23andme.txt;960545;286;9;277;7;5
user304_file162_yearofbirth_unknown_sex_unknown.23andme.txt;960545;290;13;277;4;4
user305_file133_yearofbirth_1972_sex_XY.23andme.txt;991624;297;11;286;4;4
user311_file136_yearofbirth_unknown_sex_unknown.23andme.txt;960545;290;11;279;5;5
user313_file138_yearofbirth_unknown_sex_unknown.23andme.txt;960545;290;11;279;7;5
user314_file137_yearofbirth_unknown_sex_unknown.23andme.txt;960545;286;13;273;6;5
user317_file139_yearofbirth_unknown_sex_unknown.23andme.txt;966983;298;20;278;3;4
user319_file504_yearofbirth_unknown_sex_unknown.23andme.txt;960613;288;8;280;6;5
user322_file141_yearofbirth_unknown_sex_unknown.23andme.txt;960545;286;12;274;6;5
user323_file142_yearofbirth_1983_sex_XY.23andme.txt;991624;297;12;285;16;4
user325_file149_yearofbirth_1987_sex_XY.23andme.txt;960545;286;11;275;4;4
user326_file144_yearofbirth_1987_sex_unknown.23andme.txt;960545;286;10;276;4;4
user328_file316_yearofbirth_1992_sex_XY.23andme.txt;960613;284;9;275;6;5
user329_file148_yearofbirth_unknown_sex_unknown.23andme.txt;960545;290;11;279;6;5
user330_file146_yearofbirth_unknown_sex_XY.23andme.txt;960545;286;12;274;19;5
user332_file147_yearofbirth_unknown_sex_XX.23andme.txt;960545;290;11;279;5;4
user337_file152_yearofbirth_unknown_sex_unknown.23andme.txt;960545;286;10;276;4;4
user340_file154_yearofbirth_1966_sex_XX.23andme.txt;284;0;0;0;0;0
user33_file12_yearofbirth_unknown_sex_unknown.23andme.txt;991600;297;12;285;5;5
user341_file155_yearofbirth_unknown_sex_unknown.23andme.txt;960545;290;13;277;8;5
user345_file192_yearofbirth_unknown_sex_unknown.23andme.txt;960566;290;19;271;3;4
user347_file157_yearofbirth_1952_sex_XX.23andme.txt;991624;301;12;269;461;42
user349_file160_yearofbirth_1987_sex_XY.23andme.txt;960545;286;14;272;4;4
user352_file161_yearofbirth_unknown_sex_unknown.23andme.txt;991624;301;12;289;6;4
user357_file163_yearofbirth_unknown_sex_unknown.23andme.txt;960520;286;12;274;3;4
user363_file165_yearofbirth_unknown_sex_unknown.23andme.txt;960545;286;18;268;2;4
user366_file167_yearofbirth_1950_sex_XY.23andme.txt;960545;286;10;276;7;5
user36_file14_yearofbirth_1986_sex_XY.23andme.txt;996065;307;17;290;17;5
user368_file168_yearofbirth_1958_sex_XX.23andme.txt;960545;290;15;275;6;5
user374_file169_yearofbirth_unknown_sex_unknown.23andme.txt;960545;286;12;274;5;4
user377_file171_yearofbirth_unknown_sex_unknown.23andme.txt;960545;286;11;275;5;4
user387_file173_yearofbirth_unknown_sex_unknown.23andme.txt;960545;290;13;277;5;5
user380_file172_yearofbirth_unknown_sex_XY.23andme.txt;960545;286;10;276;7;4
user38_file16_yearofbirth_1977_sex_XY.23andme.txt;960520;286;10;276;9;5
user394_file175_yearofbirth_1954_sex_XY.23andme.txt;960545;286;11;275;5;4
user39_file17_yearofbirth_unknown_sex_unknown.23andme.txt;576516;227;7;220;4;4
user397_file178_yearofbirth_1961_sex_XY.23andme.txt;960520;286;10;276;4;1
user403_file180_yearofbirth_1952_sex_XY.23andme.txt;960565;286;11;275;6;5
user407_file182_yearofbirth_unknown_sex_unknown.23andme.txt;960565;290;11;279;4;4
user409_file202_yearofbirth_unknown_sex_unknown.23andme.txt;960566;286;16;270;3;4
user411_file183_yearofbirth_unknown_sex_unknown.23andme.txt;966977;297;20;277;7;5
user40_file32_yearofbirth_unknown_sex_unknown.23andme.txt;960520;286;10;276;4;1
user420_file184_yearofbirth_unknown_sex_unknown.23andme.txt;960545;286;13;273;4;1
user423_file185_yearofbirth_unknown_sex_unknown.23andme.txt;960565;286;11;275;6;5
user429_file187_yearofbirth_unknown_sex_unknown.23andme.txt;966983;298;21;277;6;4
user42_file18_yearofbirth_1985_sex_XY.23andme.txt;966983;298;20;278;4;4
user430_file328_yearofbirth_1986_sex_XX.23andme.txt;960545;286;15;271;14;4
user436_file189_yearofbirth_unknown_sex_unknown.23andme.txt;960566;290;10;280;5;4
user439_file191_yearofbirth_unknown_sex_unknown.23andme.txt;960566;286;10;276;16;5
user437_file190_yearofbirth_1973_sex_XY.23andme.txt;996062;306;17;289;15;4
user440_file193_yearofbirth_unknown_sex_unknown.23andme.txt;960566;286;14;272;6;5
user45_file20_yearofbirth_1974_sex_XY.23andme.txt;282162;16;5;11;0;0
user441_file199_yearofbirth_unknown_sex_unknown.23andme.txt;960566;286;12;274;3;4
user442_file194_yearofbirth_1988_sex_XY.23andme.txt;960566;286;10;276;4;4
user44_file19_yearofbirth_1970_sex_XY.23andme.txt;996065;307;17;290;6;5
user463_file197_yearofbirth_1985_sex_XY.23andme.txt;960545;286;10;276;5;4
user464_file198_yearofbirth_unknown_sex_unknown.23andme.txt;960566;286;10;276;5;4
user466_file447_yearofbirth_1983_sex_unknown.23andme.txt;960613;284;8;276;4;4
user468_file200_yearofbirth_1978_sex_XX.23andme.txt;960566;290;10;280;6;5
user469_file201_yearofbirth_1993_sex_XY.23andme.txt;960566;286;10;276;4;4
user475_file211_yearofbirth_unknown_sex_XY.23andme.txt;574406;224;7;217;6;4
user473_file208_yearofbirth_unknown_sex_unknown.23andme.txt;960545;286;10;276;7;5
user478_file212_yearofbirth_unknown_sex_unknown.23andme.txt;960566;286;13;273;5;4
user47_file21_yearofbirth_1984_sex_XY.23andme.txt;960520;286;13;273;16;4
user479_file213_yearofbirth_unknown_sex_unknown.23andme.txt;960566;286;14;272;4;4
user480_file214_yearofbirth_unknown_sex_unknown.23andme.txt;960566;286;10;276;5;4
user481_file215_yearofbirth_unknown_sex_unknown.23andme.txt;960566;286;12;274;6;4
user484_file217_yearofbirth_unknown_sex_unknown.23andme.txt;960566;286;12;274;6;5
user486_file218_yearofbirth_unknown_sex_unknown.23andme.txt;966983;298;20;278;5;4
user483_file216_yearofbirth_unknown_sex_unknown.23andme.txt;960566;290;10;280;6;4
user491_file221_yearofbirth_unknown_sex_unknown.23andme.txt;960566;286;12;274;4;4
user494_file222_yearofbirth_unknown_sex_unknown.23andme.txt;966983;298;19;279;6;5
user497_file224_yearofbirth_unknown_sex_unknown.23andme.txt;966983;298;20;278;5;1
user500_file286_yearofbirth_1956_sex_XY.23andme.txt;960613;284;7;277;6;5
user495_file223_yearofbirth_1965_sex_XX.23andme.txt;960566;290;11;279;7;7
user512_file233_yearofbirth_unknown_sex_unknown.23andme.txt;1764;0;0;0;0;0
user502_file226_yearofbirth_unknown_sex_unknown.23andme.txt;960566;290;11;279;6;5
user503_file274_yearofbirth_1962_sex_XX.23andme.txt;960613;288;9;279;5;4
user505_file229_yearofbirth_unknown_sex_unknown.23andme.txt;960566;286;12;274;6;5
user513_file234_yearofbirth_unknown_sex_unknown.23andme.txt;966983;302;20;282;6;4
user518_file235_yearofbirth_unknown_sex_unknown.23andme.txt;577727;183;10;173;2;1
user519_file236_yearofbirth_1987_sex_XY.23andme.txt;960566;286;15;269;461;42
user51_file119_yearofbirth_1961_sex_XY.23andme.txt;966983;298;20;278;8;5
user526_file239_yearofbirth_unknown_sex_unknown.23andme.txt;960566;286;10;276;5;4
user528_file240_yearofbirth_unknown_sex_unknown.23andme.txt;960566;286;12;274;16;7
user536_file243_yearofbirth_unknown_sex_unknown.23andme.txt;1764;0;0;0;0;0
user530_file241_yearofbirth_1970_sex_XY.23andme.txt;960566;286;13;273;16;5
user533_file242_yearofbirth_1984_sex_XY.23andme.txt;960566;286;10;276;5;5
user538_file245_yearofbirth_unknown_sex_unknown.23andme.txt;960545;286;12;274;8;5
user539_file246_yearofbirth_1983_sex_XX.23andme.txt;960566;290;11;279;5;4
user53_file22_yearofbirth_unknown_sex_unknown.23andme.txt;960520;286;10;276;5;4
user541_file247_yearofbirth_unknown_sex_unknown.23andme.txt;960566;286;12;274;7;5
user544_file250_yearofbirth_unknown_sex_unknown.23andme.txt;966983;302;22;280;6;5
user549_file252_yearofbirth_1948_sex_XY.23andme.txt;960566;286;12;274;7;5
user54_file23_yearofbirth_1972_sex_XY.23andme.txt;966983;298;20;278;6;4
user554_file256_yearofbirth_1948_sex_XY.23andme.txt;960613;284;8;276;7;5
user555_file253_yearofbirth_unknown_sex_unknown.23andme.txt;960613;284;8;276;5;4
user558_file255_yearofbirth_unknown_sex_unknown.23andme.txt;960566;286;11;275;4;4
user556_file254_yearofbirth_unknown_sex_unknown.23andme.txt;991786;296;8;288;15;4
user55_file24_yearofbirth_unknown_sex_unknown.23andme.txt;960520;286;10;276;5;4
user561_file257_yearofbirth_unknown_sex_unknown.23andme.txt;960613;288;8;280;5;1
user563_file258_yearofbirth_1980_sex_XY.23andme.txt;960613;284;9;275;6;5
user567_file259_yearofbirth_unknown_sex_XX.23andme.txt;960613;288;9;279;7;5
user569_file260_yearofbirth_unknown_sex_unknown.23andme.txt;999215;298;9;289;4;1
user56_file25_yearofbirth_unknown_sex_unknown.23andme.txt;989791;298;21;277;6;4
user580_file265_yearofbirth_unknown_sex_unknown.23andme.txt;1766;0;0;0;0;0
user572_file261_yearofbirth_unknown_sex_unknown.23andme.txt;966977;297;20;277;7;5
user574_file262_yearofbirth_1959_sex_XY.23andme.txt;966977;297;21;276;6;4
user578_file263_yearofbirth_1980_sex_XX.23andme.txt;966983;302;20;282;5;4
user581_file266_yearofbirth_unknown_sex_unknown.23andme.txt;960545;286;11;275;6;4
user583_file268_yearofbirth_1983_sex_XY.23andme.txt;960613;284;9;275;5;4
user584_file269_yearofbirth_unknown_sex_unknown.23andme.txt;960613;284;8;276;4;4
user585_file270_yearofbirth_unknown_sex_XY.23andme.txt;960613;284;7;277;6;5
user588_file428_yearofbirth_unknown_sex_unknown.23andme.txt;960613;284;9;275;7;4
user589_file273_yearofbirth_unknown_sex_unknown.23andme.txt;960613;284;10;274;4;4
user58_file26_yearofbirth_1985_sex_XX.23andme.txt;966977;297;20;277;3;4
user594_file276_yearofbirth_unknown_sex_unknown.23andme.txt;960613;284;8;276;7;5
user595_file277_yearofbirth_unknown_sex_unknown.23andme.txt;991645;301;11;290;16;4
user59_file35_yearofbirth_unknown_sex_unknown.23andme.txt;960520;286;11;275;4;4
user604_file280_yearofbirth_unknown_sex_unknown.23andme.txt;960613;284;9;275;5;1
user602_file279_yearofbirth_unknown_sex_unknown.23andme.txt;960613;284;11;273;4;4
user607_file281_yearofbirth_1976_sex_XY.23andme.txt;960613;284;7;277;7;5
user608_file282_yearofbirth_unknown_sex_unknown.23andme.txt;574514;225;6;219;4;5
user609_file401_yearofbirth_1988_sex_XY.23andme.txt;960613;284;10;274;4;4
user60_file27_yearofbirth_1982_sex_XY.23andme.txt;991600;297;11;286;5;4
user610_file301_yearofbirth_1981_sex_XY.23andme.txt;960613;284;10;274;5;4
user613_file285_yearofbirth_unknown_sex_XY.23andme.txt;991786;296;8;288;6;5
user617_file289_yearofbirth_unknown_sex_unknown.23andme.txt;574514;225;6;219;4;5
user615_file287_yearofbirth_unknown_sex_unknown.23andme.txt;960613;284;8;276;5;1
user616_file288_yearofbirth_unknown_sex_unknown.23andme.txt;960566;290;12;278;5;4
user61_file28_yearofbirth_unknown_sex_unknown.23andme.txt;996065;307;17;290;6;4
user626_file290_yearofbirth_unknown_sex_unknown.23andme.txt;960613;284;8;276;15;4
user62_file29_yearofbirth_1966_sex_XY.23andme.txt;578339;229;7;222;15;5
user627_file291_yearofbirth_unknown_sex_unknown.23andme.txt;960613;284;9;275;4;1
user636_file292_yearofbirth_unknown_sex_unknown.23andme.txt;960613;284;8;276;5;4
user642_file294_yearofbirth_unknown_sex_unknown.23andme.txt;574514;225;5;220;2;4
user644_file295_yearofbirth_1960_sex_XY.23andme.txt;574514;225;5;220;15;4
user63_file31_yearofbirth_unknown_sex_unknown.23andme.txt;996065;307;17;290;14;4
user637_file293_yearofbirth_1989_sex_XY.23andme.txt;960613;284;8;276;4;4
user649_file335_yearofbirth_1985_sex_unknown.23andme.txt;960613;284;8;276;5;1
user648_file298_yearofbirth_1987_sex_XY.23andme.txt;960520;286;11;275;4;4
user646_file297_yearofbirth_1955_sex_XY.23andme.txt;960613;284;9;275;5;4
user645_file296_yearofbirth_1978_sex_XY.23andme.txt;960613;284;10;274;5;4
user64_file30_yearofbirth_1965_sex_XY.23andme.txt;576517;227;6;221;15;4
user662_file304_yearofbirth_unknown_sex_unknown.23andme.txt;574514;229;7;222;4;5
user650_file299_yearofbirth_1984_sex_XY.23andme.txt;960613;284;8;276;4;4
user651_file300_yearofbirth_1962_sex_XY.23andme.txt;960613;284;9;275;6;5
user663_file305_yearofbirth_unknown_sex_unknown.23andme.txt;574514;225;5;220;6;5
user662_file340_yearofbirth_unknown_sex_unknown.23andme.txt;991786;300;9;291;5;5
user667_file308_yearofbirth_unknown_sex_unknown.23andme.txt;960613;284;8;276;7;5
user668_file309_yearofbirth_unknown_sex_unknown.23andme.txt;991786;296;9;287;7;5
user669_file471_yearofbirth_1970_sex_XY.23andme.txt;960613;284;8;276;4;4
user672_file311_yearofbirth_1937_sex_XX.23andme.txt;960613;288;10;278;4;4
user673_file312_yearofbirth_unknown_sex_unknown.23andme.txt;960613;284;7;277;7;5
user675_file313_yearofbirth_unknown_sex_unknown.23andme.txt;960520;290;12;278;5;4
user678_file315_yearofbirth_1971_sex_XY.23andme.txt;991786;296;8;288;15;4
user682_file317_yearofbirth_unknown_sex_unknown.23andme.txt;574514;225;8;217;16;4
user684_file319_yearofbirth_unknown_sex_unknown.23andme.txt;960613;288;7;281;7;5
user685_file545_yearofbirth_1979_sex_XX.23andme.txt;960613;288;10;278;3;4
user688_file320_yearofbirth_1975_sex_XX.23andme.txt;960613;288;8;280;4;4
user693_file321_yearofbirth_unknown_sex_unknown.23andme.txt;574514;225;7;218;15;4
user69_file33_yearofbirth_1990_sex_XY.23andme.txt;966983;298;19;279;4;4
user6_file5_yearofbirth_1959_sex_XY.23andme.txt;1265016;235;4;231;14;4
user704_file323_yearofbirth_1976_sex_unknown.23andme.txt;574514;225;6;219;3;4
user701_file325_yearofbirth_unknown_sex_unknown.23andme.txt;960613;284;7;277;7;5
user706_file326_yearofbirth_1974_sex_XY.23andme.txt;991786;296;8;288;7;4
user707_file329_yearofbirth_unknown_sex_unknown.23andme.txt;960613;284;8;276;5;4
user70_file34_yearofbirth_1976_sex_XY.23andme.txt;576516;227;6;221;2;4
user708_file330_yearofbirth_1986_sex_XY.23andme.txt;960520;286;12;274;5;4
user716_file332_yearofbirth_1945_sex_XY.23andme.txt;574514;225;6;219;5;5
user717_file333_yearofbirth_unknown_sex_unknown.23andme.txt;574514;225;7;218;14;4
user715_file350_yearofbirth_unknown_sex_unknown.23andme.txt;960613;288;8;280;4;4
user721_file336_yearofbirth_unknown_sex_unknown.23andme.txt;960613;288;9;279;5;4
user722_file337_yearofbirth_unknown_sex_unknown.23andme.txt;960613;284;9;275;6;4
user726_file338_yearofbirth_1966_sex_XY.23andme.txt;1001422;302;8;294;15;4
user732_file342_yearofbirth_unknown_sex_unknown.23andme.txt;960613;288;8;280;4;4
user729_file339_yearofbirth_1969_sex_XY.23andme.txt;960613;284;8;276;5;4
user735_file344_yearofbirth_unknown_sex_unknown.23andme.txt;966983;298;20;278;5;5
user740_file349_yearofbirth_unknown_sex_unknown.23andme.txt;960545;286;12;274;5;4
user738_file348_yearofbirth_unknown_sex_unknown.23andme.txt;960613;288;8;280;4;4
user745_file352_yearofbirth_1972_sex_XY.23andme.txt;960613;284;9;275;5;4
user748_file354_yearofbirth_1977_sex_XX.23andme.txt;574514;229;6;223;15;4
user747_file353_yearofbirth_unknown_sex_unknown.23andme.txt;960613;288;10;278;5;4
user74_file48_yearofbirth_unknown_sex_XY.23andme.txt;960520;286;10;276;5;4
user749_file355_yearofbirth_unknown_sex_unknown.23andme.txt;960613;284;7;277;16;5
user756_file357_yearofbirth_unknown_sex_unknown.23andme.txt;172;0;0;0;0;0
user757_file359_yearofbirth_unknown_sex_unknown.23andme.txt;171;0;0;0;0;0
user754_file356_yearofbirth_unknown_sex_unknown.23andme.txt;960520;286;16;270;4;5
user758_file387_yearofbirth_unknown_sex_unknown.23andme.txt;960613;284;8;276;5;4
user75_file39_yearofbirth_1982_sex_XY.23andme.txt;966983;298;20;278;8;5
user761_file360_yearofbirth_unknown_sex_unknown.23andme.txt;960613;288;10;278;4;4
user762_file361_yearofbirth_unknown_sex_unknown.23andme.txt;966983;302;20;282;3;4
user763_file382_yearofbirth_unknown_sex_unknown.23andme.txt;960613;284;8;276;4;4
user764_file362_yearofbirth_unknown_sex_unknown.23andme.txt;960613;284;9;275;4;4
user775_file365_yearofbirth_1966_sex_XY.23andme.txt;960613;284;10;274;6;4
user776_file366_yearofbirth_unknown_sex_unknown.23andme.txt;960613;288;11;277;4;4
user777_file367_yearofbirth_unknown_sex_unknown.23andme.txt;960613;284;10;274;5;1
user778_file368_yearofbirth_unknown_sex_unknown.23andme.txt;960613;284;8;276;7;7
user779_file369_yearofbirth_unknown_sex_unknown.23andme.txt;960613;284;8;276;5;4
user77_file40_yearofbirth_1981_sex_XY.23andme.txt;903130;37;13;24;0;0
user781_file372_yearofbirth_1953_sex_XX.23andme.txt;960613;288;8;280;4;4
user785_file373_yearofbirth_1987_sex_XY.23andme.txt;10;0;0;0;0;0
user782_file371_yearofbirth_unknown_sex_XX.23andme.txt;960613;288;11;277;5;4
user784_file400_yearofbirth_unknown_sex_unknown.23andme.txt;960613;284;10;274;7;5
user784_file444_yearofbirth_unknown_sex_unknown.23andme.txt;960613;288;10;278;4;4
user785_file378_yearofbirth_1987_sex_XY.23andme.txt;960613;284;9;275;7;5
user788_file374_yearofbirth_unknown_sex_unknown.23andme.txt;960613;288;9;279;4;4
user790_file376_yearofbirth_unknown_sex_unknown.23andme.txt;960545;290;12;278;4;4
user792_file377_yearofbirth_unknown_sex_unknown.23andme.txt;960613;284;10;274;7;5
user795_file379_yearofbirth_1987_sex_XX.23andme.txt;966983;302;22;269;461;42
user798_file380_yearofbirth_unknown_sex_unknown.23andme.txt;960613;288;8;280;3;4
user803_file383_yearofbirth_1978_sex_XX.23andme.txt;960613;288;13;275;7;7
user799_file381_yearofbirth_unknown_sex_unknown.23andme.txt;960613;288;10;278;5;4
user805_file386_yearofbirth_unknown_sex_unknown.23andme.txt;991786;300;8;292;17;4
user806_file388_yearofbirth_1967_sex_XY.23andme.txt;960613;284;10;274;4;4
user807_file389_yearofbirth_unknown_sex_unknown.23andme.txt;960613;284;7;277;6;4
user808_file390_yearofbirth_unknown_sex_XY.23andme.txt;991786;296;8;288;15;5
user80_file41_yearofbirth_1979_sex_XY.23andme.txt;960520;286;10;276;5;4
user810_file392_yearofbirth_1955_sex_XY.23andme.txt;574514;225;5;220;4;5
user813_file394_yearofbirth_unknown_sex_unknown.23andme.txt;574514;225;7;218;7;5
user811_file393_yearofbirth_unknown_sex_unknown.23andme.txt;960613;288;10;278;7;5
user816_file395_yearofbirth_1983_sex_XY.23andme.txt;960613;284;10;274;16;5
user824_file404_yearofbirth_1946_sex_XY.23andme.txt;1132;0;0;0;0;0
user81_file42_yearofbirth_1977_sex_XY.23andme.txt;966983;298;19;279;3;4
user824_file405_yearofbirth_1946_sex_XY.23andme.txt;130;0;0;0;0;0
user820_file397_yearofbirth_1989_sex_XY.23andme.txt;960613;284;15;269;5;4
user827_file407_yearofbirth_unknown_sex_unknown.23andme.txt;163;0;0;0;0;0
user82_file43_yearofbirth_unknown_sex_unknown.23andme.txt;966977;297;20;277;6;5
user832_file410_yearofbirth_unknown_sex_unknown.23andme.txt;960613;284;8;276;3;4
user836_file413_yearofbirth_unknown_sex_unknown.23andme.txt;960613;284;10;274;9;5
user839_file415_yearofbirth_unknown_sex_unknown.23andme.txt;960613;284;10;269;461;42
user845_file418_yearofbirth_1985_sex_XX.23andme.txt;578337;233;6;227;4;4
user842_file417_yearofbirth_unknown_sex_unknown.23andme.txt;960613;288;9;279;4;4
user845_file419_yearofbirth_1985_sex_XX.23andme.txt;578337;229;5;224;7;5
user850_file420_yearofbirth_unknown_sex_unknown.23andme.txt;960613;284;8;276;5;5
user853_file423_yearofbirth_unknown_sex_unknown.23andme.txt;960613;284;8;276;3;4
user854_file424_yearofbirth_unknown_sex_unknown.23andme.txt;960613;284;10;274;4;4
user855_file425_yearofbirth_unknown_sex_unknown.23andme.txt;960613;284;8;276;6;4
user865_file427_yearofbirth_1979_sex_XY.23andme.txt;960545;286;10;276;4;4
user878_file467_yearofbirth_unknown_sex_XY.23andme.txt;2;0;0;0;0;0
user869_file426_yearofbirth_unknown_sex_unknown.23andme.txt;966977;297;19;278;7;5
user86_file159_yearofbirth_1986_sex_XY.23andme.txt;960545;286;10;276;4;4
user885_file431_yearofbirth_1982_sex_XY.23andme.txt;991786;296;8;288;7;5
user887_file432_yearofbirth_1946_sex_XY.23andme.txt;960613;284;10;274;5;5
user898_file441_yearofbirth_1979_sex_XY.23andme.txt;960613;284;8;276;6;4
user899_file436_yearofbirth_unknown_sex_unknown.23andme.txt;960613;288;11;277;5;4
user8_file2_yearofbirth_unknown_sex_XX.23andme.txt;966983;302;19;283;6;4
user903_file438_yearofbirth_1939_sex_XY.23andme.txt;960613;284;11;273;10;5
user906_file440_yearofbirth_unknown_sex_unknown.23andme.txt;960613;284;11;273;5;1
user907_file442_yearofbirth_unknown_sex_unknown.23andme.txt;960613;284;12;272;5;5
user90_file318_yearofbirth_1938_sex_XX.23andme.txt;579751;232;8;224;3;4
user909_file446_yearofbirth_1979_sex_XY.23andme.txt;960613;284;8;276;3;4
user910_file448_yearofbirth_1982_sex_unknown.23andme.txt;960613;288;9;279;5;4
user911_file449_yearofbirth_unknown_sex_unknown.23andme.txt;960613;288;11;277;4;4
user912_file450_yearofbirth_unknown_sex_unknown.23andme.txt;960613;288;14;274;5;5
user915_file451_yearofbirth_unknown_sex_unknown.23andme.txt;991786;296;8;288;19;5
user919_file456_yearofbirth_unknown_sex_unknown.23andme.txt;2;0;0;0;0;0
user916_file452_yearofbirth_unknown_sex_unknown.23andme.txt;991786;296;8;288;5;4
user917_file453_yearofbirth_unknown_sex_unknown.23andme.txt;960613;284;10;274;4;4
user918_file454_yearofbirth_unknown_sex_XX.23andme.txt;960613;288;9;279;6;2
user91_file46_yearofbirth_1986_sex_XY.23andme.txt;960520;286;10;276;4;4
user921_file459_yearofbirth_unknown_sex_unknown.23andme.txt;960613;284;9;275;16;5
user920_file458_yearofbirth_unknown_sex_XY.23andme.txt;960613;284;9;275;7;2
user922_file460_yearofbirth_unknown_sex_unknown.23andme.txt;960613;284;11;273;4;2
user924_file462_yearofbirth_1985_sex_XY.23andme.txt;960613;284;11;273;5;4
user927_file464_yearofbirth_unknown_sex_unknown.23andme.txt;2459;0;0;0;0;0
user937_file468_yearofbirth_unknown_sex_unknown.23andme.txt;1766;0;0;0;0;0
user926_file463_yearofbirth_1976_sex_XY.23andme.txt;960613;284;10;274;8;4
user928_file465_yearofbirth_unknown_sex_unknown.23andme.txt;960613;284;10;274;4;4
user939_file469_yearofbirth_unknown_sex_unknown.23andme.txt;578337;229;5;224;15;4
user943_file470_yearofbirth_1979_sex_XY.23andme.txt;960613;284;11;273;6;2
user951_file474_yearofbirth_unknown_sex_unknown.23andme.txt;960613;284;9;275;3;4
user951_file480_yearofbirth_unknown_sex_unknown.23andme.txt;960613;288;12;276;4;4
user952_file475_yearofbirth_1975_sex_XY.23andme.txt;960613;284;9;275;4;4
user954_file478_yearofbirth_1983_sex_XY.23andme.txt;960613;284;8;276;4;4
user966_file479_yearofbirth_unknown_sex_unknown.23andme.txt;960613;288;10;278;5;5
user968_file482_yearofbirth_1986_sex_XY.23andme.txt;960613;284;17;267;5;4
user972_file483_yearofbirth_unknown_sex_unknown.23andme.txt;960613;284;9;275;5;4
user975_file484_yearofbirth_unknown_sex_unknown.23andme.txt;960613;284;7;277;5;5
user989_file491_yearofbirth_unknown_sex_unknown.23andme.txt;701478;0;0;0;0;0
user980_file486_yearofbirth_1958_sex_XX.23andme.txt;966977;301;19;282;5;4
user984_file488_yearofbirth_unknown_sex_unknown.23andme.txt;966983;298;19;279;5;4
user988_file490_yearofbirth_unknown_sex_unknown.23andme.txt;960613;284;11;273;4;4
user994_file494_yearofbirth_1977_sex_XX.23andme.txt;701479;0;0;0;0;0
user990_file492_yearofbirth_unknown_sex_unknown.23andme.txt;960613;284;10;274;4;4
user99_file49_yearofbirth_1986_sex_XY.23andme.txt;991600;297;11;286;17;5
