File name;Lines in the file;Matched lines;Error matched lines;Number of matched SNPs;Number of Alleles matched;Number of rules triggered
user1004_file498_yearofbirth_unknown_sex_unknown.23andme.txt;1766;0;0;0;0;0
user1001_file496_yearofbirth_unknown_sex_unknown.23andme.txt;701479;0;0;0;0;0
user1005_file541_yearofbirth_1981_sex_XY.23andme.txt;707269;120;1;119;0;0
user1002_file497_yearofbirth_unknown_sex_unknown.23andme.txt;960613;288;11;277;0;1
user1006_file499_yearofbirth_unknown_sex_unknown.23andme.txt;701478;116;0;116;0;1
user1017_file505_yearofbirth_unknown_sex_unknown.23andme.txt;3;0;0;0;0;0
user1010_file502_yearofbirth_1984_sex_XY.23andme.txt;574514;225;7;218;0;1
user1013_file503_yearofbirth_unknown_sex_unknown.23andme.txt;960613;284;9;275;0;1
user1022_file508_yearofbirth_unknown_sex_unknown.23andme.txt;960613;284;10;274;0;1
user1024_file510_yearofbirth_1971_sex_XX.23andme.txt;960613;288;11;277;0;1
user1020_file507_yearofbirth_unknown_sex_unknown.23andme.txt;960613;284;8;276;0;1
user1026_file511_yearofbirth_unknown_sex_unknown.23andme.txt;960613;288;12;276;0;1
user1028_file514_yearofbirth_unknown_sex_unknown.23andme.txt;960613;288;11;277;0;1
user1033_file567_yearofbirth_1992_sex_XY.23andme.txt;960613;284;11;273;0;1
user1029_file515_yearofbirth_unknown_sex_unknown.23andme.txt;960613;288;14;274;0;1
user1034_file517_yearofbirth_unknown_sex_unknown.23andme.txt;960613;284;13;271;0;1
user1036_file519_yearofbirth_unknown_sex_unknown.23andme.txt;991786;296;9;287;0;1
user1038_file520_yearofbirth_unknown_sex_unknown.23andme.txt;960613;288;12;276;0;1
user103_file50_yearofbirth_unknown_sex_unknown.23andme.txt;966983;298;20;278;0;1
user1039_file521_yearofbirth_1958_sex_XY.23andme.txt;960613;284;11;273;0;1
user1042_file524_yearofbirth_unknown_sex_unknown.23andme.txt;701479;0;0;0;0;0
user1041_file523_yearofbirth_unknown_sex_unknown.23andme.txt;960613;288;13;275;0;1
user1040_file522_yearofbirth_unknown_sex_unknown.23andme.txt;960613;284;14;270;0;1
user1045_file526_yearofbirth_1972_sex_XX.23andme.txt;960613;288;13;275;0;1
user1046_file527_yearofbirth_unknown_sex_unknown.23andme.txt;960613;284;11;273;0;1
user1047_file528_yearofbirth_1958_sex_XY.23andme.txt;960613;284;13;271;0;1
user1048_file529_yearofbirth_unknown_sex_unknown.23andme.txt;960613;284;13;271;0;1
user1053_file531_yearofbirth_unknown_sex_unknown.23andme.txt;960613;284;11;273;0;1
user1058_file533_yearofbirth_unknown_sex_unknown.23andme.txt;960613;288;16;272;0;1
user1059_file535_yearofbirth_unknown_sex_unknown.23andme.txt;701479;115;0;115;0;1
user1051_file530_yearofbirth_1949_sex_unknown.23andme.txt;960613;288;12;276;0;1
user1060_file536_yearofbirth_1971_sex_unknown.23andme.txt;960613;284;12;272;0;1
user1062_file538_yearofbirth_unknown_sex_unknown.23andme.txt;966983;298;19;279;0;1
user1063_file540_yearofbirth_unknown_sex_unknown.23andme.txt;960613;284;14;270;0;1
user1064_file542_yearofbirth_unknown_sex_unknown.23andme.txt;960613;288;11;277;0;1
user1071_file552_yearofbirth_1968_sex_XY.23andme.txt;991786;296;10;286;0;1
user1072_file548_yearofbirth_unknown_sex_unknown.23andme.txt;960613;284;12;272;0;1
user1075_file550_yearofbirth_unknown_sex_unknown.23andme.txt;960613;288;14;274;0;1
user1066_file543_yearofbirth_unknown_sex_unknown.23andme.txt;960613;284;9;275;0;1
user1077_file551_yearofbirth_unknown_sex_unknown.23andme.txt;960613;284;12;272;0;1
user1081_file556_yearofbirth_unknown_sex_unknown.23andme.txt;2459;0;0;0;0;0
user1079_file554_yearofbirth_unknown_sex_unknown.23andme.txt;960613;288;10;278;0;1
user1078_file553_yearofbirth_1974_sex_XX.23andme.txt;701479;0;0;0;0;0
user107_file51_yearofbirth_1965_sex_XX.23andme.txt;960520;290;10;280;0;1
user1087_file558_yearofbirth_unknown_sex_unknown.23andme.txt;960613;288;11;277;0;1
user1089_file559_yearofbirth_unknown_sex_unknown.23andme.txt;960613;288;13;275;0;1
user1085_file557_yearofbirth_unknown_sex_unknown.23andme.txt;960613;284;14;270;0;1
user1091_file560_yearofbirth_1990_sex_XY.23andme.txt;960613;284;12;272;0;1
user1094_file563_yearofbirth_unknown_sex_unknown.23andme.txt;960613;284;15;269;0;1
user1103_file565_yearofbirth_unknown_sex_XX.23andme.txt;960613;288;11;277;0;1
user1097_file564_yearofbirth_unknown_sex_unknown.23andme.txt;960613;284;7;277;0;1
user10_file3_yearofbirth_1982_sex_XY.23andme.txt;966983;298;19;279;0;1
user1108_file571_yearofbirth_unknown_sex_unknown.23andme.txt;701479;0;0;0;0;0
user1106_file568_yearofbirth_unknown_sex_unknown.23andme.txt;960613;284;13;271;0;1
user1107_file570_yearofbirth_unknown_sex_XX.23andme.txt;960613;288;14;274;0;1
user1108_file572_yearofbirth_unknown_sex_unknown.23andme.txt;701479;0;0;0;0;0
user117_file53_yearofbirth_1981_sex_XY.23andme.txt;574404;224;5;219;0;1
user1112_file573_yearofbirth_unknown_sex_unknown.23andme.txt;960613;284;10;274;0;1
user1114_file574_yearofbirth_unknown_sex_unknown.23andme.txt;960613;284;17;267;0;1
user118_file52_yearofbirth_1970_sex_XY.23andme.txt;576517;227;5;222;0;1
user11_file176_yearofbirth_unknown_sex_unknown.23andme.txt;960520;286;12;274;0;1
user124_file55_yearofbirth_1947_sex_XX.23andme.txt;960520;290;10;280;0;1
user123_file54_yearofbirth_unknown_sex_unknown.23andme.txt;1003773;312;18;294;0;1
user126_file57_yearofbirth_unknown_sex_unknown.23andme.txt;578337;229;6;223;0;1
user125_file56_yearofbirth_1976_sex_XY.23andme.txt;991624;297;11;286;0;1
user139_file59_yearofbirth_unknown_sex_unknown.23andme.txt;966983;298;21;277;0;1
user137_file58_yearofbirth_unknown_sex_unknown.23andme.txt;996065;307;18;289;0;1
user141_file60_yearofbirth_unknown_sex_unknown.23andme.txt;960520;286;14;272;0;1
user13_file4_yearofbirth_1979_sex_XY.23andme.txt;966983;298;20;278;0;1
user143_file75_yearofbirth_unknown_sex_unknown.23andme.txt;574405;224;8;216;0;1
user144_file61_yearofbirth_unknown_sex_unknown.23andme.txt;966983;298;19;279;0;1
user14_file6_yearofbirth_unknown_sex_unknown.23andme.txt;576517;231;6;225;0;1
user148_file63_yearofbirth_1971_sex_XY.23andme.txt;576516;227;6;221;0;1
user146_file62_yearofbirth_1971_sex_XY.23andme.txt;960545;286;14;272;0;1
user154_file65_yearofbirth_unknown_sex_unknown.23andme.txt;966983;298;19;279;0;1
user159_file67_yearofbirth_1984_sex_XX.23andme.txt;960545;290;11;279;0;1
user160_file153_yearofbirth_unknown_sex_unknown.23andme.txt;960545;290;12;278;0;1
user158_file66_yearofbirth_unknown_sex_unknown.23andme.txt;1677118;0;0;0;0;0
user161_file68_yearofbirth_unknown_sex_unknown.23andme.txt;574405;228;5;223;0;1
user165_file71_yearofbirth_unknown_sex_unknown.23andme.txt;960545;286;11;275;0;1
user168_file73_yearofbirth_1988_sex_XY.23andme.txt;960520;286;11;275;0;1
user175_file76_yearofbirth_1974_sex_XY.23andme.txt;960545;286;10;276;0;1
user169_file74_yearofbirth_unknown_sex_unknown.23andme.txt;574405;224;6;218;0;1
user17_file143_yearofbirth_unknown_sex_XX.23andme.txt;578320;233;11;222;0;1
user177_file78_yearofbirth_unknown_sex_unknown.23andme.txt;960545;286;10;276;0;1
user180_file322_yearofbirth_1980_sex_XY.23andme.txt;574405;224;5;219;0;1
user187_file267_yearofbirth_unknown_sex_unknown.23andme.txt;574514;225;5;220;0;1
user183_file80_yearofbirth_unknown_sex_unknown.23andme.txt;960520;286;12;274;0;1
user181_file79_yearofbirth_unknown_sex_unknown.23andme.txt;960545;286;11;275;0;1
user192_file82_yearofbirth_unknown_sex_XX.23andme.txt;966983;302;19;283;0;1
user189_file174_yearofbirth_unknown_sex_unknown.23andme.txt;960545;290;11;279;0;1
user199_file86_yearofbirth_unknown_sex_unknown.23andme.txt;966983;298;23;275;0;1
user200_file84_yearofbirth_unknown_sex_unknown.23andme.txt;960545;286;10;276;0;1
user19_file7_yearofbirth_unknown_sex_unknown.23andme.txt;996062;306;18;288;0;1
user202_file85_yearofbirth_unknown_sex_unknown.23andme.txt;960545;286;11;275;0;1
user1_file9_yearofbirth_1985_sex_XY.23andme.txt;966983;298;20;278;0;1
user20_file45_yearofbirth_unknown_sex_unknown.23andme.txt;574404;224;6;218;0;1
user204_file88_yearofbirth_1957_sex_XY.23andme.txt;960545;286;12;274;0;1
user207_file89_yearofbirth_unknown_sex_unknown.23andme.txt;960545;286;11;275;0;1
user215_file91_yearofbirth_unknown_sex_unknown.23andme.txt;576516;227;14;213;0;1
user212_file90_yearofbirth_unknown_sex_unknown.23andme.txt;960545;286;11;275;0;1
user217_file92_yearofbirth_unknown_sex_unknown.23andme.txt;960545;286;13;273;0;1
user229_file102_yearofbirth_unknown_sex_unknown.23andme.txt;574405;224;5;219;0;1
user216_file109_yearofbirth_1984_sex_XY.23andme.txt;960545;286;11;275;0;1
user22_file8_yearofbirth_1975_sex_XY.23andme.txt;966977;297;19;278;0;1
user231_file93_yearofbirth_unknown_sex_unknown.23andme.txt;966983;298;20;278;0;1
user240_file94_yearofbirth_1948_sex_XX.23andme.txt;966983;302;19;283;0;1
user241_file107_yearofbirth_1984_sex_XY.23andme.txt;991624;297;12;285;0;1
user252_file99_yearofbirth_unknown_sex_unknown.23andme.txt;574405;224;5;219;0;1
user251_file97_yearofbirth_unknown_sex_XX.23andme.txt;960545;290;10;280;0;1
user253_file98_yearofbirth_unknown_sex_unknown.23andme.txt;966977;297;19;278;0;1
user254_file100_yearofbirth_1900_sex_XY.23andme.txt;966977;297;20;277;0;1
user258_file101_yearofbirth_unknown_sex_unknown.23andme.txt;960545;286;12;274;0;1
user262_file103_yearofbirth_1975_sex_XY.23andme.txt;578320;229;6;223;0;1
user266_file104_yearofbirth_unknown_sex_unknown.23andme.txt;960545;286;12;274;0;1
user267_file105_yearofbirth_unknown_sex_unknown.23andme.txt;574405;228;6;222;0;1
user277_file111_yearofbirth_unknown_sex_unknown.23andme.txt;18;0;0;0;0;0
user268_file106_yearofbirth_unknown_sex_unknown.23andme.txt;960545;290;12;278;0;1
user26_file10_yearofbirth_unknown_sex_unknown.23andme.txt;966983;298;19;279;0;1
user276_file110_yearofbirth_1972_sex_XY.23andme.txt;960545;286;10;276;0;1
user278_file112_yearofbirth_unknown_sex_XX.23andme.txt;645363;60;0;60;0;0
user279_file113_yearofbirth_unknown_sex_unknown.23andme.txt;960545;290;10;280;0;1
user280_file114_yearofbirth_1989_sex_XX.23andme.txt;991624;301;11;290;0;1
user281_file116_yearofbirth_unknown_sex_unknown.23andme.txt;960545;290;10;280;0;1
user284_file117_yearofbirth_1961_sex_XY.23andme.txt;991600;297;12;285;0;1
user288_file121_yearofbirth_1987_sex_XX.23andme.txt;960545;290;13;277;0;1
user287_file120_yearofbirth_unknown_sex_unknown.23andme.txt;966983;298;19;279;0;1
user285_file118_yearofbirth_1976_sex_XY.23andme.txt;996065;307;17;290;0;1
user294_file125_yearofbirth_1963_sex_XY.23andme.txt;966983;298;20;278;0;1
user295_file126_yearofbirth_unknown_sex_unknown.23andme.txt;966983;298;19;279;0;1
user301_file131_yearofbirth_unknown_sex_unknown.23andme.txt;960545;286;9;277;0;1
user296_file127_yearofbirth_unknown_sex_unknown.23andme.txt;960545;286;11;275;0;1
user304_file162_yearofbirth_unknown_sex_unknown.23andme.txt;960545;290;13;277;0;1
user305_file133_yearofbirth_1972_sex_XY.23andme.txt;991624;297;11;286;0;1
user311_file136_yearofbirth_unknown_sex_unknown.23andme.txt;960545;290;11;279;0;1
user313_file138_yearofbirth_unknown_sex_unknown.23andme.txt;960545;290;11;279;0;1
user314_file137_yearofbirth_unknown_sex_unknown.23andme.txt;960545;286;13;273;0;1
user317_file139_yearofbirth_unknown_sex_unknown.23andme.txt;966983;298;20;278;0;1
user322_file141_yearofbirth_unknown_sex_unknown.23andme.txt;960545;286;12;274;0;1
user319_file504_yearofbirth_unknown_sex_unknown.23andme.txt;960613;288;8;280;0;1
user323_file142_yearofbirth_1983_sex_XY.23andme.txt;991624;297;12;285;0;1
user325_file149_yearofbirth_1987_sex_XY.23andme.txt;960545;286;11;275;0;1
user326_file144_yearofbirth_1987_sex_unknown.23andme.txt;960545;286;10;276;0;1
user328_file316_yearofbirth_1992_sex_XY.23andme.txt;960613;284;9;275;0;1
user329_file148_yearofbirth_unknown_sex_unknown.23andme.txt;960545;290;11;279;0;1
user330_file146_yearofbirth_unknown_sex_XY.23andme.txt;960545;286;12;274;0;1
user340_file154_yearofbirth_1966_sex_XX.23andme.txt;284;0;0;0;0;0
user332_file147_yearofbirth_unknown_sex_XX.23andme.txt;960545;290;11;279;0;1
user337_file152_yearofbirth_unknown_sex_unknown.23andme.txt;960545;286;10;276;0;1
user33_file12_yearofbirth_unknown_sex_unknown.23andme.txt;991600;297;12;285;0;1
user341_file155_yearofbirth_unknown_sex_unknown.23andme.txt;960545;290;13;277;0;1
user345_file192_yearofbirth_unknown_sex_unknown.23andme.txt;960566;290;19;271;0;1
user347_file157_yearofbirth_1952_sex_XX.23andme.txt;991624;301;12;289;0;1
user349_file160_yearofbirth_1987_sex_XY.23andme.txt;960545;286;14;272;0;1
user352_file161_yearofbirth_unknown_sex_unknown.23andme.txt;991624;301;12;289;0;1
user357_file163_yearofbirth_unknown_sex_unknown.23andme.txt;960520;286;12;274;0;1
user363_file165_yearofbirth_unknown_sex_unknown.23andme.txt;960545;286;18;268;0;1
user366_file167_yearofbirth_1950_sex_XY.23andme.txt;960545;286;10;276;0;1
user368_file168_yearofbirth_1958_sex_XX.23andme.txt;960545;290;15;275;0;1
user36_file14_yearofbirth_1986_sex_XY.23andme.txt;996065;307;17;290;0;1
user374_file169_yearofbirth_unknown_sex_unknown.23andme.txt;960545;286;12;274;0;1
user377_file171_yearofbirth_unknown_sex_unknown.23andme.txt;960545;286;11;275;0;1
user380_file172_yearofbirth_unknown_sex_XY.23andme.txt;960545;286;10;276;0;1
user387_file173_yearofbirth_unknown_sex_unknown.23andme.txt;960545;290;13;277;0;1
user394_file175_yearofbirth_1954_sex_XY.23andme.txt;960545;286;11;275;0;1
user38_file16_yearofbirth_1977_sex_XY.23andme.txt;960520;286;10;276;0;1
user397_file178_yearofbirth_1961_sex_XY.23andme.txt;960520;286;10;276;0;1
user39_file17_yearofbirth_unknown_sex_unknown.23andme.txt;576516;227;7;220;0;1
user403_file180_yearofbirth_1952_sex_XY.23andme.txt;960565;286;11;275;0;1
user407_file182_yearofbirth_unknown_sex_unknown.23andme.txt;960565;290;11;279;0;1
user409_file202_yearofbirth_unknown_sex_unknown.23andme.txt;960566;286;16;270;0;1
user40_file32_yearofbirth_unknown_sex_unknown.23andme.txt;960520;286;10;276;0;1
user423_file185_yearofbirth_unknown_sex_unknown.23andme.txt;960565;286;11;275;0;1
user420_file184_yearofbirth_unknown_sex_unknown.23andme.txt;960545;286;13;273;0;1
user429_file187_yearofbirth_unknown_sex_unknown.23andme.txt;966983;298;21;277;0;1
user411_file183_yearofbirth_unknown_sex_unknown.23andme.txt;966977;297;20;277;0;1
user436_file189_yearofbirth_unknown_sex_unknown.23andme.txt;960566;290;10;280;0;1
user42_file18_yearofbirth_1985_sex_XY.23andme.txt;966983;298;20;278;0;1
user430_file328_yearofbirth_1986_sex_XX.23andme.txt;960545;286;15;271;0;1
user437_file190_yearofbirth_1973_sex_XY.23andme.txt;996062;306;17;289;0;1
user439_file191_yearofbirth_unknown_sex_unknown.23andme.txt;960566;286;10;276;0;1
user442_file194_yearofbirth_1988_sex_XY.23andme.txt;960566;286;10;276;0;1
user440_file193_yearofbirth_unknown_sex_unknown.23andme.txt;960566;286;14;272;0;1
user441_file199_yearofbirth_unknown_sex_unknown.23andme.txt;960566;286;12;274;0;1
user45_file20_yearofbirth_1974_sex_XY.23andme.txt;282162;16;5;11;0;0
user463_file197_yearofbirth_1985_sex_XY.23andme.txt;960545;286;10;276;0;1
user44_file19_yearofbirth_1970_sex_XY.23andme.txt;996065;307;17;290;0;1
user464_file198_yearofbirth_unknown_sex_unknown.23andme.txt;960566;286;10;276;0;1
user466_file447_yearofbirth_1983_sex_unknown.23andme.txt;960613;284;8;276;0;1
user469_file201_yearofbirth_1993_sex_XY.23andme.txt;960566;286;10;276;0;1
user475_file211_yearofbirth_unknown_sex_XY.23andme.txt;574406;224;7;217;0;1
user473_file208_yearofbirth_unknown_sex_unknown.23andme.txt;960545;286;10;276;0;1
user468_file200_yearofbirth_1978_sex_XX.23andme.txt;960566;290;10;280;0;1
user478_file212_yearofbirth_unknown_sex_unknown.23andme.txt;960566;286;13;273;0;1
user479_file213_yearofbirth_unknown_sex_unknown.23andme.txt;960566;286;14;272;0;1
user47_file21_yearofbirth_1984_sex_XY.23andme.txt;960520;286;13;273;0;1
user480_file214_yearofbirth_unknown_sex_unknown.23andme.txt;960566;286;10;276;0;1
user481_file215_yearofbirth_unknown_sex_unknown.23andme.txt;960566;286;12;274;0;1
user483_file216_yearofbirth_unknown_sex_unknown.23andme.txt;960566;290;10;280;0;1
user484_file217_yearofbirth_unknown_sex_unknown.23andme.txt;960566;286;12;274;0;1
user486_file218_yearofbirth_unknown_sex_unknown.23andme.txt;966983;298;20;278;0;1
user491_file221_yearofbirth_unknown_sex_unknown.23andme.txt;960566;286;12;274;0;1
user494_file222_yearofbirth_unknown_sex_unknown.23andme.txt;966983;298;19;279;0;1
user497_file224_yearofbirth_unknown_sex_unknown.23andme.txt;966983;298;20;278;0;1
user495_file223_yearofbirth_1965_sex_XX.23andme.txt;960566;290;11;279;0;1
user500_file286_yearofbirth_1956_sex_XY.23andme.txt;960613;284;7;277;0;1
user505_file229_yearofbirth_unknown_sex_unknown.23andme.txt;960566;286;12;274;0;1
user502_file226_yearofbirth_unknown_sex_unknown.23andme.txt;960566;290;11;279;0;1
user503_file274_yearofbirth_1962_sex_XX.23andme.txt;960613;288;9;279;0;1
user512_file233_yearofbirth_unknown_sex_unknown.23andme.txt;1764;0;0;0;0;0
user513_file234_yearofbirth_unknown_sex_unknown.23andme.txt;966983;302;20;282;0;1
user51_file119_yearofbirth_1961_sex_XY.23andme.txt;966983;298;20;278;0;1
user519_file236_yearofbirth_1987_sex_XY.23andme.txt;960566;286;15;271;0;1
user518_file235_yearofbirth_unknown_sex_unknown.23andme.txt;577727;183;10;173;0;1
user528_file240_yearofbirth_unknown_sex_unknown.23andme.txt;960566;286;12;274;0;1
user530_file241_yearofbirth_1970_sex_XY.23andme.txt;960566;286;13;273;0;1
user533_file242_yearofbirth_1984_sex_XY.23andme.txt;960566;286;10;276;0;1
user526_file239_yearofbirth_unknown_sex_unknown.23andme.txt;960566;286;10;276;0;1
user536_file243_yearofbirth_unknown_sex_unknown.23andme.txt;1764;0;0;0;0;0
user538_file245_yearofbirth_unknown_sex_unknown.23andme.txt;960545;286;12;274;0;1
user539_file246_yearofbirth_1983_sex_XX.23andme.txt;960566;290;11;279;0;1
user53_file22_yearofbirth_unknown_sex_unknown.23andme.txt;960520;286;10;276;0;1
user541_file247_yearofbirth_unknown_sex_unknown.23andme.txt;960566;286;12;274;0;1
user544_file250_yearofbirth_unknown_sex_unknown.23andme.txt;966983;302;22;280;0;1
user549_file252_yearofbirth_1948_sex_XY.23andme.txt;960566;286;12;274;0;1
user54_file23_yearofbirth_1972_sex_XY.23andme.txt;966983;298;20;278;0;1
user554_file256_yearofbirth_1948_sex_XY.23andme.txt;960613;284;8;276;0;1
user555_file253_yearofbirth_unknown_sex_unknown.23andme.txt;960613;284;8;276;0;1
user556_file254_yearofbirth_unknown_sex_unknown.23andme.txt;991786;296;8;288;0;1
user55_file24_yearofbirth_unknown_sex_unknown.23andme.txt;960520;286;10;276;0;1
user558_file255_yearofbirth_unknown_sex_unknown.23andme.txt;960566;286;11;275;0;1
user563_file258_yearofbirth_1980_sex_XY.23andme.txt;960613;284;9;275;0;1
user561_file257_yearofbirth_unknown_sex_unknown.23andme.txt;960613;288;8;280;0;1
user567_file259_yearofbirth_unknown_sex_XX.23andme.txt;960613;288;9;279;0;1
user569_file260_yearofbirth_unknown_sex_unknown.23andme.txt;999215;298;9;289;0;1
user574_file262_yearofbirth_1959_sex_XY.23andme.txt;966977;297;21;276;0;1
user572_file261_yearofbirth_unknown_sex_unknown.23andme.txt;966977;297;20;277;0;1
user56_file25_yearofbirth_unknown_sex_unknown.23andme.txt;989791;298;21;277;0;1
user578_file263_yearofbirth_1980_sex_XX.23andme.txt;966983;302;20;282;0;1
user580_file265_yearofbirth_unknown_sex_unknown.23andme.txt;1766;0;0;0;0;0
user583_file268_yearofbirth_1983_sex_XY.23andme.txt;960613;284;9;275;0;1
user584_file269_yearofbirth_unknown_sex_unknown.23andme.txt;960613;284;8;276;0;1
user581_file266_yearofbirth_unknown_sex_unknown.23andme.txt;960545;286;11;275;0;1
user585_file270_yearofbirth_unknown_sex_XY.23andme.txt;960613;284;7;277;0;1
user588_file428_yearofbirth_unknown_sex_unknown.23andme.txt;960613;284;9;275;0;1
user589_file273_yearofbirth_unknown_sex_unknown.23andme.txt;960613;284;10;274;0;1
user58_file26_yearofbirth_1985_sex_XX.23andme.txt;966977;297;20;277;0;1
user594_file276_yearofbirth_unknown_sex_unknown.23andme.txt;960613;284;8;276;0;1
user595_file277_yearofbirth_unknown_sex_unknown.23andme.txt;991645;301;11;290;0;1
user59_file35_yearofbirth_unknown_sex_unknown.23andme.txt;960520;286;11;275;0;1
user602_file279_yearofbirth_unknown_sex_unknown.23andme.txt;960613;284;11;273;0;1
user604_file280_yearofbirth_unknown_sex_unknown.23andme.txt;960613;284;9;275;0;1
user608_file282_yearofbirth_unknown_sex_unknown.23andme.txt;574514;225;6;219;0;1
user607_file281_yearofbirth_1976_sex_XY.23andme.txt;960613;284;7;277;0;1
user609_file401_yearofbirth_1988_sex_XY.23andme.txt;960613;284;10;274;0;1
user60_file27_yearofbirth_1982_sex_XY.23andme.txt;991600;297;11;286;0;1
user610_file301_yearofbirth_1981_sex_XY.23andme.txt;960613;284;10;274;0;1
user613_file285_yearofbirth_unknown_sex_XY.23andme.txt;991786;296;8;288;0;1
user617_file289_yearofbirth_unknown_sex_unknown.23andme.txt;574514;225;6;219;0;1
user616_file288_yearofbirth_unknown_sex_unknown.23andme.txt;960566;290;12;278;0;1
user615_file287_yearofbirth_unknown_sex_unknown.23andme.txt;960613;284;8;276;0;1
user61_file28_yearofbirth_unknown_sex_unknown.23andme.txt;996065;307;17;290;0;1
user62_file29_yearofbirth_1966_sex_XY.23andme.txt;578339;229;7;222;0;1
user626_file290_yearofbirth_unknown_sex_unknown.23andme.txt;960613;284;8;276;0;1
user627_file291_yearofbirth_unknown_sex_unknown.23andme.txt;960613;284;9;275;0;1
user636_file292_yearofbirth_unknown_sex_unknown.23andme.txt;960613;284;8;276;0;1
user637_file293_yearofbirth_1989_sex_XY.23andme.txt;960613;284;8;276;0;1
user642_file294_yearofbirth_unknown_sex_unknown.23andme.txt;574514;225;5;220;0;1
user63_file31_yearofbirth_unknown_sex_unknown.23andme.txt;996065;307;17;290;0;1
user644_file295_yearofbirth_1960_sex_XY.23andme.txt;574514;225;5;220;0;1
user646_file297_yearofbirth_1955_sex_XY.23andme.txt;960613;284;9;275;0;1
user645_file296_yearofbirth_1978_sex_XY.23andme.txt;960613;284;10;274;0;1
user648_file298_yearofbirth_1987_sex_XY.23andme.txt;960520;286;11;275;0;1
user649_file335_yearofbirth_1985_sex_unknown.23andme.txt;960613;284;8;276;0;1
user64_file30_yearofbirth_1965_sex_XY.23andme.txt;576517;227;6;221;0;1
user662_file304_yearofbirth_unknown_sex_unknown.23andme.txt;574514;229;7;222;0;1
user650_file299_yearofbirth_1984_sex_XY.23andme.txt;960613;284;8;276;0;1
user651_file300_yearofbirth_1962_sex_XY.23andme.txt;960613;284;9;275;0;1
user663_file305_yearofbirth_unknown_sex_unknown.23andme.txt;574514;225;5;220;0;1
user662_file340_yearofbirth_unknown_sex_unknown.23andme.txt;991786;300;9;291;0;1
user667_file308_yearofbirth_unknown_sex_unknown.23andme.txt;960613;284;8;276;0;1
user668_file309_yearofbirth_unknown_sex_unknown.23andme.txt;991786;296;9;287;0;1
user669_file471_yearofbirth_1970_sex_XY.23andme.txt;960613;284;8;276;0;1
user672_file311_yearofbirth_1937_sex_XX.23andme.txt;960613;288;10;278;0;1
user673_file312_yearofbirth_unknown_sex_unknown.23andme.txt;960613;284;7;277;0;1
user675_file313_yearofbirth_unknown_sex_unknown.23andme.txt;960520;290;12;278;0;1
user682_file317_yearofbirth_unknown_sex_unknown.23andme.txt;574514;225;8;217;0;1
user678_file315_yearofbirth_1971_sex_XY.23andme.txt;991786;296;8;288;0;1
user684_file319_yearofbirth_unknown_sex_unknown.23andme.txt;960613;288;7;281;0;1
user685_file545_yearofbirth_1979_sex_XX.23andme.txt;960613;288;10;278;0;1
user693_file321_yearofbirth_unknown_sex_unknown.23andme.txt;574514;225;7;218;0;1
user688_file320_yearofbirth_1975_sex_XX.23andme.txt;960613;288;8;280;0;1
user69_file33_yearofbirth_1990_sex_XY.23andme.txt;966983;298;19;279;0;1
user6_file5_yearofbirth_1959_sex_XY.23andme.txt;1265016;235;4;231;0;1
user701_file325_yearofbirth_unknown_sex_unknown.23andme.txt;960613;284;7;277;0;1
user704_file323_yearofbirth_1976_sex_unknown.23andme.txt;574514;225;6;219;0;1
user706_file326_yearofbirth_1974_sex_XY.23andme.txt;991786;296;8;288;0;1
user707_file329_yearofbirth_unknown_sex_unknown.23andme.txt;960613;284;8;276;0;1
user70_file34_yearofbirth_1976_sex_XY.23andme.txt;576516;227;6;221;0;1
user708_file330_yearofbirth_1986_sex_XY.23andme.txt;960520;286;12;274;0;1
user715_file350_yearofbirth_unknown_sex_unknown.23andme.txt;960613;288;8;280;0;1
user717_file333_yearofbirth_unknown_sex_unknown.23andme.txt;574514;225;7;218;0;1
user716_file332_yearofbirth_1945_sex_XY.23andme.txt;574514;225;6;219;0;1
user721_file336_yearofbirth_unknown_sex_unknown.23andme.txt;960613;288;9;279;0;1
user722_file337_yearofbirth_unknown_sex_unknown.23andme.txt;960613;284;9;275;0;1
user729_file339_yearofbirth_1969_sex_XY.23andme.txt;960613;284;8;276;0;1
user726_file338_yearofbirth_1966_sex_XY.23andme.txt;1001422;302;8;294;0;1
user732_file342_yearofbirth_unknown_sex_unknown.23andme.txt;960613;288;8;280;0;1
user735_file344_yearofbirth_unknown_sex_unknown.23andme.txt;966983;298;20;278;0;1
user738_file348_yearofbirth_unknown_sex_unknown.23andme.txt;960613;288;8;280;0;1
user740_file349_yearofbirth_unknown_sex_unknown.23andme.txt;960545;286;12;274;0;1
user745_file352_yearofbirth_1972_sex_XY.23andme.txt;960613;284;9;275;0;1
user748_file354_yearofbirth_1977_sex_XX.23andme.txt;574514;229;6;223;0;1
user747_file353_yearofbirth_unknown_sex_unknown.23andme.txt;960613;288;10;278;0;1
user756_file357_yearofbirth_unknown_sex_unknown.23andme.txt;172;0;0;0;0;0
user757_file359_yearofbirth_unknown_sex_unknown.23andme.txt;171;0;0;0;0;0
user749_file355_yearofbirth_unknown_sex_unknown.23andme.txt;960613;284;7;277;0;1
user74_file48_yearofbirth_unknown_sex_XY.23andme.txt;960520;286;10;276;0;1
user754_file356_yearofbirth_unknown_sex_unknown.23andme.txt;960520;286;16;270;0;1
user758_file387_yearofbirth_unknown_sex_unknown.23andme.txt;960613;284;8;276;0;1
user761_file360_yearofbirth_unknown_sex_unknown.23andme.txt;960613;288;10;278;0;1
user75_file39_yearofbirth_1982_sex_XY.23andme.txt;966983;298;20;278;0;1
user762_file361_yearofbirth_unknown_sex_unknown.23andme.txt;966983;302;20;282;0;1
user763_file382_yearofbirth_unknown_sex_unknown.23andme.txt;960613;284;8;276;0;1
user764_file362_yearofbirth_unknown_sex_unknown.23andme.txt;960613;284;9;275;0;1
user775_file365_yearofbirth_1966_sex_XY.23andme.txt;960613;284;10;274;0;1
user776_file366_yearofbirth_unknown_sex_unknown.23andme.txt;960613;288;11;277;0;1
user777_file367_yearofbirth_unknown_sex_unknown.23andme.txt;960613;284;10;274;0;1
user778_file368_yearofbirth_unknown_sex_unknown.23andme.txt;960613;284;8;276;0;1
user779_file369_yearofbirth_unknown_sex_unknown.23andme.txt;960613;284;8;276;0;1
user77_file40_yearofbirth_1981_sex_XY.23andme.txt;903130;37;13;24;0;0
user781_file372_yearofbirth_1953_sex_XX.23andme.txt;960613;288;8;280;0;1
user785_file373_yearofbirth_1987_sex_XY.23andme.txt;10;0;0;0;0;0
user782_file371_yearofbirth_unknown_sex_XX.23andme.txt;960613;288;11;277;0;1
user784_file400_yearofbirth_unknown_sex_unknown.23andme.txt;960613;284;10;274;0;1
user784_file444_yearofbirth_unknown_sex_unknown.23andme.txt;960613;288;10;278;0;1
user785_file378_yearofbirth_1987_sex_XY.23andme.txt;960613;284;9;275;0;1
user788_file374_yearofbirth_unknown_sex_unknown.23andme.txt;960613;288;9;279;0;1
user790_file376_yearofbirth_unknown_sex_unknown.23andme.txt;960545;290;12;278;0;1
user792_file377_yearofbirth_unknown_sex_unknown.23andme.txt;960613;284;10;274;0;1
user795_file379_yearofbirth_1987_sex_XX.23andme.txt;966983;302;22;280;0;1
user798_file380_yearofbirth_unknown_sex_unknown.23andme.txt;960613;288;8;280;0;1
user799_file381_yearofbirth_unknown_sex_unknown.23andme.txt;960613;288;10;278;0;1
user803_file383_yearofbirth_1978_sex_XX.23andme.txt;960613;288;13;275;0;1
user806_file388_yearofbirth_1967_sex_XY.23andme.txt;960613;284;10;274;0;1
user805_file386_yearofbirth_unknown_sex_unknown.23andme.txt;991786;300;8;292;0;1
user807_file389_yearofbirth_unknown_sex_unknown.23andme.txt;960613;284;7;277;0;1
user810_file392_yearofbirth_1955_sex_XY.23andme.txt;574514;225;5;220;0;1
user80_file41_yearofbirth_1979_sex_XY.23andme.txt;960520;286;10;276;0;1
user808_file390_yearofbirth_unknown_sex_XY.23andme.txt;991786;296;8;288;0;1
user813_file394_yearofbirth_unknown_sex_unknown.23andme.txt;574514;225;7;218;0;1
user811_file393_yearofbirth_unknown_sex_unknown.23andme.txt;960613;288;10;278;0;1
user816_file395_yearofbirth_1983_sex_XY.23andme.txt;960613;284;10;274;0;1
user824_file404_yearofbirth_1946_sex_XY.23andme.txt;1132;0;0;0;0;0
user81_file42_yearofbirth_1977_sex_XY.23andme.txt;966983;298;19;279;0;1
user824_file405_yearofbirth_1946_sex_XY.23andme.txt;130;0;0;0;0;0
user827_file407_yearofbirth_unknown_sex_unknown.23andme.txt;163;0;0;0;0;0
user820_file397_yearofbirth_1989_sex_XY.23andme.txt;960613;284;15;269;0;1
user82_file43_yearofbirth_unknown_sex_unknown.23andme.txt;966977;297;20;277;0;1
user832_file410_yearofbirth_unknown_sex_unknown.23andme.txt;960613;284;8;276;0;1
user836_file413_yearofbirth_unknown_sex_unknown.23andme.txt;960613;284;10;274;0;1
user839_file415_yearofbirth_unknown_sex_unknown.23andme.txt;960613;284;10;274;0;1
user845_file418_yearofbirth_1985_sex_XX.23andme.txt;578337;233;6;227;0;1
user845_file419_yearofbirth_1985_sex_XX.23andme.txt;578337;229;5;224;0;1
user842_file417_yearofbirth_unknown_sex_unknown.23andme.txt;960613;288;9;279;0;1
user850_file420_yearofbirth_unknown_sex_unknown.23andme.txt;960613;284;8;276;0;1
user853_file423_yearofbirth_unknown_sex_unknown.23andme.txt;960613;284;8;276;0;1
user854_file424_yearofbirth_unknown_sex_unknown.23andme.txt;960613;284;10;274;0;1
user855_file425_yearofbirth_unknown_sex_unknown.23andme.txt;960613;284;8;276;0;1
user865_file427_yearofbirth_1979_sex_XY.23andme.txt;960545;286;10;276;0;1
user878_file467_yearofbirth_unknown_sex_XY.23andme.txt;2;0;0;0;0;0
user869_file426_yearofbirth_unknown_sex_unknown.23andme.txt;966977;297;19;278;0;1
user86_file159_yearofbirth_1986_sex_XY.23andme.txt;960545;286;10;276;0;1
user887_file432_yearofbirth_1946_sex_XY.23andme.txt;960613;284;10;274;0;1
user885_file431_yearofbirth_1982_sex_XY.23andme.txt;991786;296;8;288;0;1
user898_file441_yearofbirth_1979_sex_XY.23andme.txt;960613;284;8;276;0;1
user899_file436_yearofbirth_unknown_sex_unknown.23andme.txt;960613;288;11;277;0;1
user8_file2_yearofbirth_unknown_sex_XX.23andme.txt;966983;302;19;283;0;1
user903_file438_yearofbirth_1939_sex_XY.23andme.txt;960613;284;11;273;0;1
user906_file440_yearofbirth_unknown_sex_unknown.23andme.txt;960613;284;11;273;0;1
user907_file442_yearofbirth_unknown_sex_unknown.23andme.txt;960613;284;12;272;0;1
user90_file318_yearofbirth_1938_sex_XX.23andme.txt;579751;232;8;224;0;1
user909_file446_yearofbirth_1979_sex_XY.23andme.txt;960613;284;8;276;0;1
user910_file448_yearofbirth_1982_sex_unknown.23andme.txt;960613;288;9;279;0;1
user911_file449_yearofbirth_unknown_sex_unknown.23andme.txt;960613;288;11;277;0;1
user912_file450_yearofbirth_unknown_sex_unknown.23andme.txt;960613;288;14;274;0;1
user915_file451_yearofbirth_unknown_sex_unknown.23andme.txt;991786;296;8;288;0;1
user919_file456_yearofbirth_unknown_sex_unknown.23andme.txt;2;0;0;0;0;0
user916_file452_yearofbirth_unknown_sex_unknown.23andme.txt;991786;296;8;288;0;1
user917_file453_yearofbirth_unknown_sex_unknown.23andme.txt;960613;284;10;274;0;1
user918_file454_yearofbirth_unknown_sex_XX.23andme.txt;960613;288;9;279;0;1
user921_file459_yearofbirth_unknown_sex_unknown.23andme.txt;960613;284;9;275;0;1
user920_file458_yearofbirth_unknown_sex_XY.23andme.txt;960613;284;9;275;0;1
user91_file46_yearofbirth_1986_sex_XY.23andme.txt;960520;286;10;276;0;1
user927_file464_yearofbirth_unknown_sex_unknown.23andme.txt;2459;0;0;0;0;0
user922_file460_yearofbirth_unknown_sex_unknown.23andme.txt;960613;284;11;273;0;1
user937_file468_yearofbirth_unknown_sex_unknown.23andme.txt;1766;0;0;0;0;0
user924_file462_yearofbirth_1985_sex_XY.23andme.txt;960613;284;11;273;0;1
user926_file463_yearofbirth_1976_sex_XY.23andme.txt;960613;284;10;274;0;1
user939_file469_yearofbirth_unknown_sex_unknown.23andme.txt;578337;229;5;224;0;1
user928_file465_yearofbirth_unknown_sex_unknown.23andme.txt;960613;284;10;274;0;1
user943_file470_yearofbirth_1979_sex_XY.23andme.txt;960613;284;11;273;0;1
user951_file480_yearofbirth_unknown_sex_unknown.23andme.txt;960613;288;12;276;0;1
user951_file474_yearofbirth_unknown_sex_unknown.23andme.txt;960613;284;9;275;0;1
user954_file478_yearofbirth_1983_sex_XY.23andme.txt;960613;284;8;276;0;1
user966_file479_yearofbirth_unknown_sex_unknown.23andme.txt;960613;288;10;278;0;1
user968_file482_yearofbirth_1986_sex_XY.23andme.txt;960613;284;17;267;0;1
user972_file483_yearofbirth_unknown_sex_unknown.23andme.txt;960613;284;9;275;0;1
user980_file486_yearofbirth_1958_sex_XX.23andme.txt;966977;301;19;282;0;1
user975_file484_yearofbirth_unknown_sex_unknown.23andme.txt;960613;284;7;277;0;1
user989_file491_yearofbirth_unknown_sex_unknown.23andme.txt;701478;0;0;0;0;0
user988_file490_yearofbirth_unknown_sex_unknown.23andme.txt;960613;284;11;273;0;1
user984_file488_yearofbirth_unknown_sex_unknown.23andme.txt;966983;298;19;279;0;1
user994_file494_yearofbirth_1977_sex_XX.23andme.txt;701479;0;0;0;0;0
user990_file492_yearofbirth_unknown_sex_unknown.23andme.txt;960613;284;10;274;0;1
user99_file49_yearofbirth_1986_sex_XY.23andme.txt;991600;297;11;286;0;1
